# -- 
# -- 麻雀用語辞書
# -- Revision 22
# -- 
# -- この変換辞書データはクリエイティブ・コモンズ「表示-継承 2.1 日本」
# -- ライセンスの下で利用できます。詳細は次のサイトを参照してください。
# --
# --     http://creativecommons.org/licenses/by-sa/2.1/jp/
# -- 
# -- なお、この辞書の（編集）著作権は、これを利用して入力した文章には
# -- 及びません。文章の著作権は、その著作者に属します。
# --
# --                                                      武者 晶紀
# -- 
# -- This work is licensed and protected under a Creative Commons
# -- Attribution-Share Alike 2.1 Japan License.
# -- 
# -- Copyright (c) 2004-2011 Akinori MUSHA <Akinori@MUSHA.org>
# -- 

あかうら	赤裏	【名詞】
あかうー	赤五	【名詞】
あかぎ	アカギ	【固名】
あかどら	赤ドラ	【名詞】
あかはい	赤牌	【名詞】
あが	和了	【ラ五】
あがらす	アガラス	【名詞】
あがり	和了り	【名詞】
あがりけい	和了り形	【名詞】
あがりほうき	和了り放棄	【名詞】
あがりめ	和了り目	【名詞】
あがりやく	和了り役	【名詞】
あがりやめ	和了り止め	【名詞】
あがりれんちゃん	和了り連荘	【名詞】
あが３	アガ三	【名詞】
あくうかん	亜空間	【名詞】
あたまはね	頭ハネ	【名詞】
あたりはい	当たり牌	【名詞】
あつしぼ	熱シボ	【名詞】
あつちゃ	熱茶	【名詞】
あとがけ	後掛け	【名詞】
あとづけ	後付け	【名サ】
あとひっかけ	後引っ掛け	【名詞】
あんかん	暗槓	【名サ】
あんかんつ	暗槓子	【名サ】
あんこ	暗刻	【ラ五】
あんこ	暗刻	【名詞】
あんこおとし	暗刻落とし	【名サ】
あんこー	暗刻	【名詞】
あんこーつ	暗刻子	【名詞】
あんしゅんつ	暗順子	【名詞】
あんぜんはい	安全牌	【名詞】
あんぜんぱい	安全牌	【名詞】
あんぱい	安牌	【名詞】
いちきゅうじはい	一九字牌	【名詞】
いちきゅうはい	一九牌	【名詞】
いちじゃんとう	一雀頭	【名詞】
いちどふり	一度振り	【名サ】
いちなき	一哭き	【名サ】
いちなき	一鳴き	【名サ】
いちまんてんぼう	万点棒	【名詞】
いっきつうかん	一気通貫	【名詞】
いっしょくて	一色手	【名詞】
いっつう	一通	【名詞】
いまてん	今テン	【名サ】
いりめ	入り目	【名詞】
いー	一	【数詞】
いーしゃんてん	一向聴	【名詞】
いーすー	一四	【数詞】
いーすーそー	一四索	【名詞】
いーすーちー	一四七	【数詞】
いーすーちーそー	一四七索	【名詞】
いーすーちーぴん	一四七筒	【名詞】
いーすーちーわん	一四七萬	【名詞】
いーすーぴん	一四筒	【名詞】
いーすーわん	一四萬	【名詞】
いーそー	一索	【名詞】
いーちゃん	一荘	【名詞】
いーとん	一幢	【名詞】
いーはんしばり	二飜縛り	【名詞】
いーぴん	一筒	【名詞】
いーぺー	一盃	【名詞】
いーぺーこー	一盃口	【名詞】
いーわん	一萬	【名詞】
うえづも	上ヅモ	【名詞】
うかせうち	浮かせ打ち	【名サ】
うきはい	浮き牌	【名詞】
うじゅう	右十	【名詞】
うに	右二	【名詞】
うま	ウマ	【名詞】
うらすじ	裏スジ	【名詞】
うらすじ	裏筋	【名詞】
うらどら	裏ドラ	【名詞】
うらめ	裏目	【ラ五】
うらめんつ	裏面子	【名詞】
うろく	右六	【名詞】
うわづも	上ヅモ	【名詞】
うー	五	【数詞】
うーそー	五索	【名詞】
うーぱー	五八	【数詞】
うーぱーそー	五八索	【名詞】
うーぱーぴん	五八筒	【名詞】
うーぱーわん	五八萬	【名詞】
うーぴん	五筒	【名詞】
うーわん	五萬	【名詞】
おうはい	王牌	【名詞】
おくりかん	送り槓	【名詞】
おたかぜ	オタ風	【名詞】
おたかぜ	客風	【名詞】
おなてん	同聴	【名サ】
おにづも	鬼ヅモ	【名サ】
おにびき	鬼引き	【名サ】
おもうら	表裏	【名詞】
おやおち	親落ち	【名サ】
おやかぶり	親かぶり	【名サ】
おやぎめ	親決め	【名サ】
おやっかぶり	親っかぶり	【名サ】
おやっぱね	親っパネ	【名詞】
おやっぱね	親っ跳ね	【名詞】
おやながれ	親流れ	【名サ】
おやばい	親倍	【名詞】
おやばいまん	親倍満	【名詞】
おやまん	親満	【名詞】
おやりー	親リー	【名サ】
おり	オリ	【ラ五】
おり	オリ	【名詞】
おり	降り	【名詞】
おりうち	オリ打ち	【名サ】
おりうち	降り打ち	【名サ】
おーぷんりーち	オープンリーチ	【名詞】
おーぷんりーち	オープン立直	【名詞】
おーらす	オーラス	【名詞】
おーる	オール	【接尾】
かいめん	開門	【名サ】
かえりとん	帰り東	【名詞】
かおじゃみ	顔三味	【名詞】
かおじゃみせん	顔三味線	【名詞】
かかん	加槓	【名サ】
かすて	カス手	【名詞】
かずはい	数牌	【名詞】
かぜはい	風牌	【名詞】
かぞえやくまん	数え役満	【名詞】
かたあがり	片和了り	【名詞】
かふ	加符	【名詞】
かべはい	壁牌	【名詞】
かみちゃ	上家	【名詞】
かみちゃどり	上家取り	【名詞】
からかん	空カン	【名サ】
からかん	空槓	【名サ】
からぎり	空切り	【名サ】
からちー	空チー	【名サ】
からちー	空吃	【名サ】
からてん	空テン	【名サ】
からてん	空聴	【名サ】
からぽん	空ポン	【名サ】
かりおや	仮親	【名詞】
かりかり	仮仮	【名詞】
かりてん	仮テン	【名サ】
かりてん	仮聴	【名サ】
かりとん	仮東	【名詞】
かん	カン	【名サ】
かん	槓	【名サ】
かんうら	カン裏	【名詞】
かんうら	槓裏	【名詞】
かんうらどら	カン裏ドラ	【名詞】
かんうらどら	槓裏ドラ	【名詞】
かんさき	完先	【名詞】
かんざい	槓材	【名詞】
かんたー	嵌塔	【名詞】
かんちゃん	嵌張	【名詞】
かんちゃんてん	嵌張聴	【名詞】
かんちゃんまち	嵌張待ち	【名詞】
かんつ	槓子	【ラ五】
かんつ	槓子	【名詞】
かんぶり	槓振り	【名サ】
がんぱい	ガン牌	【名詞】
きけんはい	危険牌	【名詞】
きゃくふう	客風	【名詞】
きゃくふうはい	客風牌	【名詞】
きゅうしゅきゅうはい	九種九牌	【名詞】
きゅうしゅとうはい	九種倒牌	【名詞】
きょうぎまーじゃん	競技麻雀	【名詞】
きりあげまんがん	切り上げ満貫	【名詞】
きりはい	切り牌	【名詞】
きんしんぱい	筋心牌	【名詞】
くいかえ	喰い替え	【名サ】
くいさが	喰い下が	【ラ五】
くいさがり	喰い下がり	【名サ】
くいさげ	喰い下げ	【ラ五】
くいじかけ	喰い仕掛け	【ラ五】
くいじかけ	喰い仕掛け	【名詞】
くいたん	喰いタン	【名詞】
くいたん	喰い断	【名詞】
くいと	喰い取	【ラ五】
くいなお	喰い直	【サ五】
くいなおし	喰い直し	【名サ】
くいなが	喰い流	【サ五】
くいながれ	喰い流れ	【一段】
くいぴん	喰いピン	【名詞】
くいぴん	喰い平	【名詞】
くうかん	空カン	【名サ】
くうかん	空槓	【名サ】
くうたく	空卓	【名詞】
くうちー	空チー	【名サ】
くうちー	空吃	【名サ】
くうぽん	空ポン	【名サ】
くずて	クズ手	【名詞】
くっつきてんぱい	くっつき聴牌	【名詞】
けいてん	形テン	【名サ】
けいてん	形聴	【名サ】
けふー	懸副	【名詞】
げんばり	現張り	【名サ】
げんろくづみ	元禄積み	【名詞】
こうはい	好牌	【名詞】
こうはい	荒牌	【名詞】
こうはいせんだ	好牌先打	【名詞】
こうぱい	好牌	【名詞】
こうぱいせんだ	好牌先打	【名詞】
こくし	国士	【名詞】
こくしむそう	国士無双	【名詞】
こてがえし	小手返し	【名詞】
こば	小場	【名詞】
こまりょう	コマ両	【名サ】
こりつはい	孤立牌	【名詞】
こーつ	刻子	【名詞】
ごかん	誤カン	【名サ】
ごかん	誤槓	【名サ】
ごしゃろくにゅう	五捨六入	【名サ】
ごせんてんぼう	五千点棒	【名詞】
ごせんりょう	五千両	【名サ】
ごちー	誤チー	【名サ】
ごちー	誤吃	【名サ】
ごつも	誤ツモ	【名サ】
ごふーろ	誤副露	【名サ】
ごぽん	誤ポン	【名サ】
ごみて	ゴミ手	【名詞】
ごろん	誤ロン	【名サ】
ごろん	誤栄	【名サ】
さきぎり	先切り	【名サ】
さきづけ	先付け	【名サ】
さきづも	先ヅモ	【名サ】
さし	左四	【名詞】
さぶろー	三六	【数詞】
さぶろーそー	三六索	【名詞】
さぶろーちゅー	三六九	【数詞】
さぶろーちゅーそー	三六九索	【名詞】
さぶろーちゅーぴん	三六九筒	【名詞】
さぶろーちゅーわん	三六九萬	【名詞】
さぶろーぴん	三六筒	【名詞】
さぶろーわん	三六萬	【名詞】
さんあんこ	三暗刻	【名詞】
さんあんこー	三暗刻	【名詞】
さんかんつ	三槓子	【名詞】
さんげんはい	三元牌	【名詞】
さんげんぱい	三元牌	【名詞】
さんしき	三色	【名詞】
さんしきどうこー	三色同刻	【名詞】
さんしきどうじゅん	三色同順	【名詞】
さんしょく	三色	【名詞】
さんしょくどうこー	三色同刻	【名詞】
さんしょくどうじゅん	三色同順	【名詞】
さんそー	三索	【名詞】
さんぞー	三索	【名詞】
さんちゃ	三家	【名詞】
さんちゃ	三着	【名詞】
さんちゃ	散家	【名詞】
さんちゃほー	三家和	【名詞】
さんばいまん	三倍満	【名詞】
さんばいまんがん	三倍満貫	【名詞】
さんぴん	三筒	【名詞】
さんま	三麻	【名詞】
さんわん	三萬	【名詞】
したづも	下ヅモ	【名詞】
しばぼう	柴棒	【名詞】
しもちゃ	下家	【名詞】
しゃちゃ	下家	【名詞】
しゃぼ	シャボ	【名詞】
しゃぼまち	シャボ待ち	【名詞】
しゃみ	三味	【名詞】
しゃんちゃ	上家	【名詞】
しゃんてん	向聴	【助数】
しゃんてんすう	向聴数	【名詞】
しゃんぽん	双ポン	【名詞】
しゃんぽんてん	双ポン聴	【名詞】
しゃんぽんまち	双ポン待ち	【名詞】
しゃー	西	【名詞】
しゃーちゃ	西家	【名詞】
しゃーにゅう	西入	【名サ】
しゃーば	西場	【名詞】
しゃーらす	南ラス	【名詞】
しゃーらす	西ラス	【名詞】
しゃー１	西一	【名詞】
しゃー１きょく	西一局	【名詞】
しゃー２	西二	【名詞】
しゃー２きょく	西二局	【名詞】
しゃー３	西三	【名詞】
しゃー３きょく	西三局	【名詞】
しゃー４	西四	【名詞】
しゃー４きょく	西四局	【名詞】
しゅんつ	順子	【名詞】
しゅーぱい	数牌	【名詞】
しょうさんげん	小三元	【名詞】
しょうしゃりん	小車輪	【名詞】
しょうすーしー	小四喜	【名詞】
しょうはい	少牌	【名サ】
しょうぶて	勝負手	【名詞】
しょうみんかん	小明槓	【名サ】
しょはい	初牌	【名詞】
しょんはい	生牌	【名詞】
しょんぱい	生牌	【名詞】
しょーぱい	熟牌	【名詞】
しろぽっち	白ポッチ	【名詞】
しー	十	【数詞】
しーさん	十三	【数詞】
しーさんぷーたー	十三不塔	【名詞】
しーさんやおちゅー	十三幺九	【名詞】
しーはい	洗牌	【名サ】
しーぱい	屍牌	【名詞】
しーぱい	洗牌	【名サ】
じおや	自親	【名詞】
じかぜ	自風	【名詞】
じく	自九	【名詞】
じご	自五	【名詞】
じどうたく	自動卓	【名詞】
じはい	字牌	【名詞】
じゃんき	雀鬼	【名詞】
じゃんごう	雀豪	【名詞】
じゃんせい	雀聖	【名詞】
じゃんそう	雀荘	【名詞】
じゃんたく	雀卓	【名詞】
じゃんとう	雀頭	【名詞】
じゃんぱい	雀牌	【名詞】
じゃんゆう	雀友	【名詞】
じゃんりゅうもん	雀龍門	【固名】
じゅん	巡	【助数】
じゅんちゃん	純全	【名詞】
じゅんちゃんた	純全帯	【名詞】
じゅんちゃんたいやお	純全帯幺	【名詞】
じゅんめ	巡目	【助数】
じゅんめ	巡目	【名詞】
すうはい	数牌	【名詞】
すうぱい	数牌	【名詞】
すじ	スジ	【名詞】
すじひっかけ	スジ引っ掛け	【名詞】
すじひっかけ	筋引っ掛け	【名詞】
すったん	四単	【名詞】
すてはい	捨牌	【名詞】
すー	四	【数詞】
すーあんこ	四暗刻	【名詞】
すーあんこー	四暗刻	【名詞】
すーかんつ	四槓子	【名詞】
すーそー	四索	【名詞】
すーちー	四七	【数詞】
すーちーそー	四七索	【名詞】
すーちーぴん	四七筒	【名詞】
すーちーわん	四七萬	【名詞】
すーぴん	四筒	【名詞】
すーふうしれんだ	四風子連打	【名詞】
すーふぉんつれんだ	四風子連打	【名詞】
すーわん	四萬	【名詞】
せきにんばらい	責任払い	【名詞】
せんてんぼう	千点棒	【名詞】
せんりょう	千両	【名サ】
ぜついちもん	絶一門	【名詞】
ぜんつっぱ	全ツッパ	【名サ】
そくりー	即リー	【名サ】
そばてん	側聴	【名詞】
そめて	染め手	【名詞】
そー	索	【助数】
そー	索	【名詞】
そーず	索子	【名詞】
たかめ	高目	【名詞】
たくがい	卓外	【名詞】
たくがいせん	卓外戦	【名詞】
たくぎめ	卓決め	【名サ】
たくぐみ	卓組み	【名サ】
たこあがり	タコ和了り	【名サ】
たこづも	タコヅモ	【名サ】
たちおや	立ち親	【名詞】
たてちん	立て清	【名詞】
たてほん	立て混	【名詞】
ためんちゃん	多門張	【名詞】
ためんてん	多面聴	【名詞】
ためんまち	多面待ち	【名詞】
たんき	単騎	【名詞】
たんきてん	単騎聴	【名詞】
たんきまち	単騎待ち	【名詞】
たんちゃおてん	単吊聴	【名詞】
たんづも	タンヅモ	【名詞】
たんづも	断ヅモ	【名詞】
たんやお	断幺	【名詞】
たんやおちゅー	断幺九	【名詞】
たんやおはい	断幺牌	【名詞】
たーつ	塔子	【名詞】
たーはい	多牌	【名サ】
だいさんげん	大三元	【名詞】
だいしゃりん	大車輪	【名詞】
だいすーしー	大四喜	【名詞】
だいみんかん	大明槓	【名サ】
だはい	打牌	【名詞】
だぶかぜ	ダブ風	【名詞】
だぶしゃー	ダブ西	【名詞】
だぶとん	ダブ東	【名詞】
だぶなん	ダブ南	【名詞】
だぶぺー	ダブ北	【名詞】
だぶりー	ダブリー	【名サ】
だぶるやくまん	ダブル役満	【名詞】
だぶるりーち	ダブルリーチ	【名サ】
だぶるりーち	ダブル立直	【名サ】
だぶろん	ダブロン	【名サ】
だま	ダマ	【名詞】
だま	黙	【名詞】
だまてん	ダマ聴	【名サ】
だまてん	黙聴	【名サ】
ちぇんちゃん	尖張	【名詞】
ちぇんぱい	尖牌	【名詞】
ちぇーいーめん	絶一門	【名詞】
ちくはい	築牌	【名サ】
ちゃいつ	賽子	【名詞】
ちゃいつ	骰子	【名詞】
ちゃかん	加槓	【名サ】
ちゃんかん	搶槓	【名詞】
ちゃんた	全帯	【名詞】
ちゃんたいやお	全帯幺	【名詞】
ちゃんちゃ	荘家	【名詞】
ちゃんふう	荘風	【名詞】
ちゃんふうぱい	荘風牌	【名詞】
ちゃんふぉんぱい	荘風牌	【名詞】
ちゅん	中	【名詞】
ちゅんちゃんぱい	中張牌	【名詞】
ちゅー	九	【数詞】
ちゅーそー	九索	【名詞】
ちゅーぴん	九筒	【名詞】
ちゅーれん	九連	【名詞】
ちゅーれんぽーとー	九連宝灯	【名詞】
ちゅーわん	九萬	【名詞】
ちょくがけ	直掛け	【名詞】
ちょんちょん	チョンチョン	【名サ】
ちょんびーぱい	城壁牌	【名詞】
ちょんぼ	チョンボ	【名サ】
ちょんぼ	錯和	【名サ】
ちんいち	清一	【名詞】
ちんいつ	清一	【名詞】
ちんいーそー	清一色	【名詞】
ちんろう	清老	【名詞】
ちんろうとう	清老頭	【名詞】
ちー	チー	【名サ】
ちー	七	【数詞】
ちー	吃	【名サ】
ちーそー	七索	【名詞】
ちーちゃ	起家	【名詞】
ちーちゃぎめ	起家決め	【名サ】
ちーてん	チーテン	【名サ】
ちーてん	吃聴	【名サ】
ちーとい	七対	【名詞】
ちーといつ	七対子	【名詞】
ちーぴん	七筒	【名詞】
ちーほー	地和	【名詞】
ちーわん	七萬	【名詞】
つかん	ツカン	【名詞】
つかんぽ	ツカンポ	【名詞】
つきはい	憑き牌	【名詞】
つみば	積み場	【名詞】
つみぼう	積み棒	【名詞】
つめしぼ	冷シボ	【名詞】
つめちゃ	冷茶	【名詞】
つも	ツモ	【ラ五】
つも	自摸	【ラ五】
つも	自摸	【名サ】
つもあが	ツモ和了	【ラ五】
つもあがり	ツモ和了り	【名サ】
つもぎ	ツモ切	【ラ五】
つもじゅん	ツモ順	【名詞】
つもっぱね	ツモッパネ	【名詞】
つもっぱね	ツモッ跳ね	【名詞】
つもばい	ツモ倍	【名詞】
つもばん	ツモ番	【名詞】
つもぴん	ツモピン	【名詞】
つもぴん	ツモ平	【名詞】
つもほー	自摸和	【名詞】
つもり	ツモり	【接頭】
つーいーそー	字一色	【名詞】
つーちゃんす	ツーチャンス	【名詞】
つーぱい	字牌	【名詞】
づがん	ヅガン	【名詞】
づも	ヅモ	【接尾】
てぃんちゃん	頂張	【名詞】
てぃんちゃんぱい	頂張牌	【名詞】
てがわり	手変わり	【名サ】
てぎり	手切り	【名サ】
てじゃみ	手三味	【名詞】
てじゃみせん	手三味線	【名詞】
てだし	手出し	【名サ】
てつまん	徹麻	【名サ】
てづみ	手積み	【名サ】
てづみたく	手積み卓	【名詞】
てはい	手牌	【名詞】
てやく	手役	【名詞】
てんご	点五	【名詞】
てんぱい	聴牌	【名サ】
てんぱね	点パネ	【名サ】
てんぴん	点ピン	【名詞】
てんほう	天鳳	【固名】
てんほー	天和	【名詞】
てんぼう	点棒	【名詞】
てん５	点五	【名詞】
であがり	出和了り	【名サ】
でおや	出親	【名詞】
できん	出禁	【名詞】
でば	出場	【名詞】
でばい	出倍	【名詞】
でばさい	出場最	【名詞】
と	ト	【バ五】
といさん	対三	【名詞】
といしち	対七	【名詞】
といじゅういち	対十一	【名詞】
といちゃ	対家	【名詞】
といつ	対子	【ラ五】
といつ	対子	【名詞】
といつおとし	対子落とし	【名サ】
といつば	対子場	【名詞】
といとい	対々	【名詞】
といといほう	対々和	【名詞】
といはい	推牌	【名サ】
といめん	対面	【名詞】
とうはい	倒牌	【名詞】
とうはい	闘牌	【名詞】
とおし	通し	【接尾】
とおすじ	遠スジ	【名詞】
とおすじ	遠筋	【名詞】
とおらば	通らば	【接頭】
とりぷるろん	トリプルロン	【名サ】
とりろん	トリロン	【名サ】
とん	幢	【助数】
とん	東	【名詞】
とんちゃ	東家	【名詞】
とんなん	東南	【名詞】
とんなんしゃーぺー	東南西北	【名詞】
とんなんせん	東南戦	【名詞】
とんなんまわし	東南廻し	【名詞】
とんば	東場	【名詞】
とんぱつ	東初	【名詞】
とんぱつ	東発	【名詞】
とんぷう	東風	【名詞】
とんぷうせん	東風戦	【名詞】
とんぷうそう	東風荘	【名詞】
とんらす	東ラス	【名詞】
とん１	東一	【名詞】
とん１きょく	東一局	【名詞】
とん２	東二	【名詞】
とん２きょく	東二局	【名詞】
とん３	東三	【名詞】
とん３きょく	東三局	【名詞】
とん４	東四	【名詞】
とん４きょく	東四局	【名詞】
どうじゅん	同巡	【名詞】
どうじゅんない	同巡内	【名詞】
どうたく	同卓	【名サ】
どたかめ	ド高目	【名詞】
どやすめ	ド安目	【名詞】
どら	ドラ	【名詞】
どらぎり	ドラ切り	【名サ】
どらすじ	ドラ筋	【名詞】
どらそば	ドラ側	【名詞】
どらまたぎ	ドラ跨ぎ	【名詞】
な	哭	【カ五】
なかすじ	中スジ	【名詞】
なかすじ	中筋	【名詞】
なかぶくれ	中膨れ	【名詞】
ながしまんがん	流し満貫	【名詞】
なき	哭き	【名詞】
なき	鳴き	【名詞】
なきのりゅう	哭きの竜	【固名】
なん	南	【名詞】
なんちゃ	南家	【名詞】
なんにゅう	南入	【名サ】
なんば	南場	【名詞】
なんぱつ	南初	【名詞】
なんぱつ	南発	【名詞】
なん１	南一	【名詞】
なん１きょく	南一局	【名詞】
なん２	南二	【名詞】
なん２きょく	南二局	【名詞】
なん３	南三	【名詞】
なん３きょく	南三局	【名詞】
なん４	南四	【名詞】
なん４きょく	南四局	【名詞】
にちゃ	二着	【名詞】
にどぶり	二度振り	【名サ】
になき	二哭き	【名サ】
になき	二鳴き	【名サ】
ぬきどら	抜きドラ	【名詞】
ぬけばん	抜け番	【名詞】
のべたん	延べ単	【名詞】
のみ	ノミ	【接尾】
のみて	ノミ手	【名詞】
のーちゃんす	ノーチャンス	【名詞】
のーてん	ノーテン	【名詞】
のーてん	不聴	【名詞】
はい	牌	【名詞】
はいぎ	牌技	【名詞】
はいこうかん	牌交換	【名サ】
はいし	牌姿	【名詞】
はいてい	海底	【名詞】
はいていらおゆえ	海底撈月	【名詞】
はいぱい	配牌	【名詞】
はいふ	牌譜	【名詞】
はいりめ	入り目	【名詞】
はおぱいせんたー	好牌先打	【名詞】
はく	白	【名詞】
はくはつちゅん	白発中	【名詞】
はこ	ハコ	【ラ五】
はこ	ハコ	【名詞】
はこかぶり	ハコかぶり	【名詞】
はこした	ハコ下	【名詞】
はこてん	ハコテン	【名詞】
はこてん	ハコ点	【名詞】
はこわれ	ハコ割れ	【名詞】
はしはい	端牌	【名詞】
はじはい	端牌	【名詞】
はだかたんき	裸単騎	【名詞】
はつ	発	【名詞】
はなはい	花牌	【名詞】
はねご	跳ね五	【名詞】
はねすりー	跳ねスリー	【名詞】
はねせん	跳ね千	【名詞】
はねちょく	跳ね直	【名サ】
はねまん	跳ね満	【名詞】
はねまんがん	跳ね満貫	【名詞】
はやあがり	早和了り	【名サ】
はん	飜	【助数】
はんしばり	飜縛り	【名詞】
はんちゃん	半荘	【名詞】
はんぱい	飜牌	【名詞】
はんやく	飜役	【助数】
ばいちょく	倍直	【名サ】
ばいまん	倍満	【名詞】
ばいまんがん	倍満貫	【名詞】
ばかぜ	場風	【名詞】
ばかちん	バカ清	【名詞】
ばかづき	バカヅキ	【名サ】
ばかほん	バカ混	【名詞】
ばがえ	場替え	【名サ】
ばぎめ	場決め	【名サ】
ばくしゅび	爆守備	【名詞】
ばしょがえ	場所替え	【名サ】
ばしょぎめ	場所決め	【名サ】
ばぞろ	場ゾロ	【名詞】
ばだい	場代	【名詞】
ばだいがち	場代勝ち	【名サ】
ばだいまけ	場代負け	【名サ】
ばった	バッタ	【名詞】
ばったまち	バッタ待ち	【名詞】
ばっぷ	罰符	【名詞】
ばんばん	バンバン	【名詞】
ぱい	牌	【名詞】
ぱいぱん	白板	【名詞】
ぱお	包	【名詞】
ぱおそく	包則	【名詞】
ぱおはい	包牌	【名詞】
ぱー	八	【数詞】
ぱーそー	八索	【名詞】
ぱーぴん	八筒	【名詞】
ぱーれんちゃん	八連荘	【名詞】
ぱーわん	八萬	【名詞】
ひだりじゅうに	左十二	【名詞】
ひだりっぱ	左八	【名詞】
ひつようはい	必要牌	【名詞】
ひゃくてんぼう	百点棒	【名詞】
ひょうじはい	表示牌	【名詞】
ぴん	筒	【助数】
ぴん	筒	【名詞】
ぴんじゃん	ピン雀	【名詞】
ぴんじゃんそう	ピン雀荘	【名詞】
ぴんず	筒子	【名詞】
ぴんちゅい	平局	【名詞】
ぴんづも	ピンヅモ	【名詞】
ぴんづも	平ヅモ	【名詞】
ぴんふ	平和	【名詞】
ぴーぱい	壁牌	【名詞】
ふぁぱい	発牌	【名詞】
ふぁんちゃん	放銃	【名詞】
ふぁんちゅん	紅中	【名詞】
ふぁんぱい	飜牌	【名詞】
ふうはい	風牌	【名詞】
ふぉんつ	風子	【名詞】
ふぉんぱい	風牌	【名詞】
ふすう	符数	【名詞】
ふせはい	伏せ牌	【名サ】
ふはね	符ハネ	【名サ】
ふようはい	不要牌	【名詞】
ふりてん	フリテン	【名詞】
ふりてん	振聴	【名詞】
ふーしーぱい	浮屍牌	【名詞】
ふーてい	副底	【名詞】
ふーろ	副露	【名サ】
ふーろはい	副露牌	【名詞】
ぷんりー	プンリー	【名詞】
へいきょく	平局	【名詞】
べたおり	ベタオリ	【名サ】
ぺんたー	辺塔	【名詞】
ぺんちゃん	辺張	【名詞】
ぺんちゃんてん	辺張聴	【名詞】
ぺんちゃんまち	辺張待ち	【名詞】
ぺー	北	【名詞】
ぺーちゃ	北家	【名詞】
ぺーにゅー	北入	【名サ】
ぺーば	北場	【名詞】
ぺーらす	北ラス	【名詞】
ぺー１	北一	【名詞】
ぺー１きょく	北一局	【名詞】
ぺー２	北二	【名詞】
ぺー２きょく	北二局	【名詞】
ぺー３	北三	【名詞】
ぺー３きょく	北三局	【名詞】
ぺー４	北四	【名詞】
ぺー４きょく	北四局	【名詞】
ほうじゅう	放銃	【名詞】
ほうちゃん	放銃	【名詞】
ほうてい	河底	【名詞】
ほおていらおゆい	河底撈魚	【名詞】
ほんいち	混一	【名詞】
ほんいつ	混一	【名詞】
ほんいーそー	混一色	【名詞】
ほんちゃんた	混全帯	【名詞】
ほんちゃんたいやお	混全帯幺	【名詞】
ほんろう	混老	【名詞】
ほんろうとう	混老頭	【名詞】
ほー	河	【名詞】
ほーちゃん	放銃	【名詞】
ほーら	和了	【名詞】
ぼうてん	棒聴	【名サ】
ぼうはい	暴牌	【名詞】
ぽん	ポン	【名サ】
ぽんかす	ポンカス	【名詞】
ぽんざい	ポン材	【名詞】
ぽんてん	ポン聴	【名サ】
まいづかい	枚使い	【助数】
まえひっかけ	前引っ掛け	【名詞】
またぎすじ	跨ぎスジ	【名詞】
またぎすじ	跨ぎ筋	【名詞】
まち	待ち	【名詞】
まち	待ち	【接尾】
まちけい	待ち形	【名詞】
まちごろ	待ち頃	【名詞】
まちはい	待ち牌	【名詞】
まるじゃん	Maru-Jan	【固名】
まるのり	丸乗り	【名サ】
まわしう	回し打	【タ五】
まわしうち	回し打ち	【名サ】
まん	萬	【助数】
まんがん	満貫	【名詞】
まんご	満五	【名詞】
まんすりー	満スリー	【名詞】
まんず	萬子	【名詞】
まんせん	満千	【名詞】
まんたく	満卓	【名詞】
まんちょく	満直	【名サ】
まんてんぼう	万点棒	【名詞】
まんりょう	万両	【名サ】
まーじゃん	麻雀	【名サ】
みかんつ	未槓子	【名詞】
みせはい	見せ牌	【名サ】
みんかん	明槓	【名サ】
みんこ	明刻	【名詞】
みんこー	明刻	【名詞】
みんこーつ	明刻子	【名詞】
みんしゅん	明順	【名詞】
みんしゅんつ	明順子	【名詞】
むすじ	無スジ	【名詞】
むすじ	無筋	【名詞】
むりすじ	無理筋	【名詞】
むりちん	無理清	【名詞】
むりなき	無理哭き	【名サ】
むりなき	無理鳴き	【名サ】
むりほん	無理混	【名詞】
めんぜん	門前	【名詞】
めんぜんちん	門前清	【名詞】
めんぜんやく	門前役	【名詞】
めんたん	メンタン	【名詞】
めんたん	門断	【名詞】
めんたんぴん	メンタンピン	【名詞】
めんたんぴん	門断平	【名詞】
めんちゃん	門張	【助数】
めんちん	メンチン	【名詞】
めんちん	門清	【名詞】
めんつ	面子	【名詞】
めんつおとし	面子落とし	【名サ】
めんつたーたー	面子多多	【名詞】
めんてん	面聴	【助数】
めんぴん	メンピン	【名詞】
めんぴん	門平	【名詞】
めんふぉんぱい	門風牌	【名詞】
めんほん	メンホン	【名詞】
めんほん	門混	【名詞】
もうはい	盲牌	【名サ】
もうぱい	盲牌	【名サ】
もしらす	もしラス	【名詞】
もちもち	持ち持ち	【名詞】
もろがけ	諸掛け	【名詞】
もろひっかけ	諸引っ掛け	【名詞】
もーたー	摸打	【名サ】
もーぱい	摸牌	【名詞】
もーほー	摸和	【名サ】
やおちゃん	要張	【名詞】
やおちゃんぱい	要張牌	【名詞】
やおちゅーはい	幺九牌	【名詞】
やおちゅーふりきり	幺九振り切り	【名詞】
やくあり	役あり	【名詞】
やくづくり	役作り	【名サ】
やくなし	役なし	【名詞】
やくはい	役牌	【名詞】
やくまん	役満	【名詞】
やすて	安手	【名詞】
やすて	激安手	【名詞】
やすめ	安目	【名詞】
やまぎり	山切り	【名サ】
やまごし	山越し	【名詞】
やみてん	ヤミテン	【名詞】
やみてん	闇聴	【名サ】
やみてんぱい	闇聴牌	【名サ】
ゆうこうはい	有効牌	【名詞】
よんちゃ	四家	【名詞】
よんま	四麻	【名詞】
よんめんつ	四面子	【名詞】
らくはい	落牌	【名サ】
らす	ラス	【名詞】
らすあがり	ラス和了り	【名詞】
らすおや	ラス親	【名詞】
らすはい	ラス牌	【名詞】
らすはん	ラス半	【名詞】
らすまえ	ラス前	【名詞】
りゃん	両	【数詞】
りゃん	二	【数詞】
りゃんうー	二五	【数詞】
りゃんうーそー	二五索	【名詞】
りゃんうーぱー	二五八	【数詞】
りゃんうーぱーそー	二五八索	【名詞】
りゃんうーぱーぴん	二五八筒	【名詞】
りゃんうーぱーわん	二五八萬	【名詞】
りゃんうーぴん	二五筒	【名詞】
りゃんうーわん	二五萬	【名詞】
りゃんかん	両嵌	【名詞】
りゃんかんちゃん	両嵌張	【名詞】
りゃんし	リャンシ	【名詞】
りゃんしば	リャン縛	【名詞】
りゃんしば	二縛	【名詞】
りゃんしゃんてん	二向聴	【名詞】
りゃんそー	二索	【名詞】
りゃんぞー	二索	【名詞】
りゃんたー	両塔	【名詞】
りゃんちゃ	二家	【名詞】
りゃんはんしばり	二飜縛り	【名詞】
りゃんぴん	二筒	【名詞】
りゃんぺー	二盃	【名詞】
りゃんぺーこー	二盃口	【名詞】
りゃんめん	両面	【名詞】
りゃんめん	二面	【名詞】
りゃんめんまち	両面待ち	【名サ】
りゃんめんまち	二面待ち	【名サ】
りゃんわん	二萬	【名詞】
りゅうきょく	流局	【名サ】
りゅーいーそー	緑一色	【名詞】
りゅーふぁ	緑発	【名詞】
りんしゃん	嶺上	【名詞】
りんしゃんかいほー	嶺上開花	【名詞】
りんしゃんはい	嶺上牌	【名詞】
りんぱい	零牌	【名詞】
りーそく	リー即	【名詞】
りーち	リーチ	【名サ】
りーち	立直	【名サ】
りーちしゃ	リーチ者	【名詞】
りーちしゃ	立直者	【名詞】
りーちはい	リーチ牌	【名詞】
りーちはい	立直牌	【名詞】
りーちぼう	リーチ棒	【名詞】
りーちぼう	立直棒	【名詞】
りーはい	理牌	【名サ】
りーぱい	理牌	【名サ】
りーぼう	リー棒	【名詞】
れんたい	連対	【名詞】
れんたいき	連隊旗	【名詞】
れんちゃん	連荘	【助数】
れんちゃん	連荘	【名詞】
れんてい	連底	【名詞】
れんふぉんぱい	連風牌	【名詞】
れんぷうはい	連風牌	【名詞】
れんほー	人和	【名詞】
ろうとうはい	老頭牌	【名詞】
ろくまいぎり	六枚切り	【名サ】
ろん	ロン	【名サ】
ろん	栄	【名サ】
ろんちゃん	輪荘	【名詞】
ろんほー	栄和	【名詞】
ろー	六	【数詞】
ろーそー	六索	【名詞】
ろーちゅー	六九	【数詞】
ろーちゅーそー	六九索	【名詞】
ろーちゅーぴん	六九筒	【名詞】
ろーちゅーわん	六九萬	【名詞】
ろーぴん	六筒	【名詞】
ろーわん	六萬	【名詞】
わん	萬	【助数】
わんず	萬子	【名詞】
わんちゃんす	ワンチャンス	【名詞】
わんぱい	王牌	【名詞】
１そー	一索	【名詞】
１ぴん	一筒	【名詞】
１まん	一萬	【名詞】
１わん	一萬	【名詞】
１４	一四	【数詞】
１４そー	一四索	【名詞】
１４ぴん	一四筒	【名詞】
１４わん	一四萬	【名詞】
１４７	一四七	【数詞】
１４７そー	一四七索	【名詞】
１４７ぴん	一四七筒	【名詞】
１４７わん	一四七萬	【名詞】
２そー	二索	【名詞】
２ぴん	二筒	【名詞】
２まん	二萬	【名詞】
２わん	二萬	【名詞】
２５	二五	【数詞】
２５そー	二五索	【名詞】
２５ぴん	二五筒	【名詞】
２５わん	二五萬	【名詞】
２５８	二五八	【数詞】
２５８そー	二五八索	【名詞】
２５８ぴん	二五八筒	【名詞】
２５８わん	二五八萬	【名詞】
３そー	三索	【名詞】
３ぴん	三筒	【名詞】
３まん	三萬	【名詞】
３わん	三萬	【名詞】
３６	三六	【数詞】
３６そー	三六索	【名詞】
３６ぴん	三六筒	【名詞】
３６わん	三六萬	【名詞】
３６９	三六九	【数詞】
３６９そー	三六九索	【名詞】
３６９ぴん	三六九筒	【名詞】
３６９わん	三六九萬	【名詞】
４そー	四索	【名詞】
４ぴん	四筒	【名詞】
４まん	四萬	【名詞】
４わん	四萬	【名詞】
４７	四七	【数詞】
４７そー	四七索	【名詞】
４７ぴん	四七筒	【名詞】
４７わん	四七萬	【名詞】
５そー	五索	【名詞】
５ぴん	五筒	【名詞】
５まん	五萬	【名詞】
５わん	五萬	【名詞】
５８	五八	【数詞】
５８そー	五八索	【名詞】
５８ぴん	五八筒	【名詞】
５８わん	五八萬	【名詞】
６そー	六索	【名詞】
６ぴん	六筒	【名詞】
６まん	六萬	【名詞】
６わん	六萬	【名詞】
６９	六九	【数詞】
６９そー	六九索	【名詞】
６９ぴん	六九筒	【名詞】
６９わん	六九萬	【名詞】
７そー	七索	【名詞】
７ぴん	七筒	【名詞】
７まん	七萬	【名詞】
７わん	七萬	【名詞】
８そー	八索	【名詞】
８ぴん	八筒	【名詞】
８まん	八萬	【名詞】
８わん	八萬	【名詞】
９そー	九索	【名詞】
９ぴん	九筒	【名詞】
９まん	九萬	【名詞】
９わん	九萬	【名詞】
